GGGGGGGGGGGGGGGGGGSSTTTTTTTTTTTT
GGGGGGGGGGGGGGGGGGGSSTTTTTTTTTTT
GTTTGGGGTSSTTGGGGGGGSSSTTTTTTTTT
TTTTGGTTTTTTTTTGGGGGGGGTTTTTTTTT
TTTGGGTTTTTTTTGGGGGGGGGGTTTTTTTT
TTTGGGGTTTTTTGGGGGGGGGGGGTTTTTTT
TTTGGGTTTTTGGGGGGGGGGGGGTTTTTTTT
TTGGGTTTTTSGGGGGGGGGGGGSSTTTTTTT
TTGGGTTTTSGGGGGGGGGGGGGSSTTTTTTT
TSGGGTTTSSGGGGGGGGGGGGGSTTTTTTTT
TSSGGTTTGGGGGGGGGGGGGGGTTTTTTTTT
TTTGGGGGGGGGGGGGGGGGGGGTTTTTTTTT
TTTGGGGGTTGGGGGGGGGGGGGGGGTTTTTT
TTGGGSSTTTTTSSSGGGGGGGGTGGGGSTTT
TTGGSSTTTTTTTTSSGGGGGGTTTTGGGGTT
TTTTTTTTTTTTTTTTTTTTTTTTTTTTTTTT